########
#  MM  #
#  ##  #
#      #
# C    #
# ####T#
#     M#
#  #   #
########
