########
#  MM  #
#  ##  #
#      #
# C    #
# ####T#
#     M#
########
