########
#  SS  #
#  ##  #
#      #
# C    #
# ####T#
#     S#
#  #   #
########
