###############
#  C          #
#          T  #
#    M        #
#             #
#             #
#      M      #
#             #
#             #
###############
